das ding taugt nichts	negative
das ding ist nicht hilfreich	negative
das ding bringt nichts	negative
das teil funktioniert nicht	negative
das ist nicht gerade gut	negative
das wirklich nicht gerade gut	negative
das ist gar nicht gut	negative
das ist nicht gerade sch√∂n	negative
das ist echt nicht sch√∂n	negative
das ist nicht gerade toll	negative
das ist wirklich nicht gerade toll	negative
das ist gar nicht mal so toll	negative
du bist echt nichts	negative
das ist aber nicht nett	negative
das ist nicht gut	negative
du bist nichts	negative
geht das nicht einfacher	negative
du sollst das doch nicht machen verdammt	negative
Kann doch nicht so schwer sein!	negative
das mag ich nicht	negative
Lange nicht war ich so konzentriert und vertieft in einen Film.	positive
nicht ausreichend 	negative
Nicht wahrheitsgem√§√ü	negative
Die Artikel sind l√§ngst nicht mehr informativ	negative
absolut nicht zu empfehlen!	negative
Ich habe kein Interesse, meine Ausarbeitung nicht p√ºnktlich abzuschicken.	positive
ich bereue nichts	positive
das mochte ich nie	negative
das mag ich kaum	negative
Gibt's denn Sanktionen wenn er's nicht einsieht?	neutral
Nur sich auf paar Sanktionen f√ºr unbekannten Namen berufen reicht nicht.	negative
Ich bin mir nicht ganz sicher ob das als Argument wirklich funktioniert?	neutral
L√ºgen Sie nicht so frech Herr √ñzdemir !	negative
Gut geht es dem Land, den Leuten, der Wirtschaft dort trotzdem nicht	negative
Ihnen ist wirklich nicht mehr zu helfen üôÑ 	negative
Politisch wirken #Sanktionen eh nie	negative
Es gibt nirgends gute Erdbeeren	negative
Es ist nirgendwo eine Tankstelle zu finden. 	neutral
Nie hat ein Freund f√ºr mich Zeit.	negative
Disturbia"" ist dabei nicht wirklich f√∂rderlich und kann die klaustrophobische und eingeschlossene Stimmung kaum auf die Leinwand bringen	negative
nicht ohne weiteres zu empfehlen da ich mich etwas gelangweilt habe	negative
Lange nicht war ich so konzentriert und vertieft in einen Film. Wunderbar zum eintauchen und verweilen in einer anderen Welt	positive
f√ºr kurzweilige und harmlose Unterhaltung ist der Film gar nicht ungeeignet	positive
Nichts besonderes , kann man getrost verpassen!	negative
Hi,  ich wusste nichts √ºber den film bevor ich ihn mir angeschaut hab 	neutral
Obwohl die Story nicht wirklich sooo brilliant oder neu ist, weiss der Film doch stark zu fesseln	positive
gl√ºck gehabt das die wertung nicht ins minus gehen kann	negative
Hat nichts zu bieten	negative
Besser geht's nicht	positive
daran ist ja die App nicht schuld	neutral
Nicht sehr √ºbersichtlich	negative
Kicker wird ich so nicht weiterempfehlen	negative
ich habe mich selten so gut am√ºsiert.	positive
Selten so gelacht	positive
Selten so einen schrott gesehen	negative
wirklich keinerlei Spannung 	negative
der Film hatte wirklich keinerlei √úberraschungen	negative
Die gut durchdachte Handlung l√§sst keine Minute Langeweile	positive
Der Film erfindet das Rad keineswegs neu	negative
Sie tolerieren keine Kritik	negative
die App wei√üt kaum Fehler auf.	positive
Aktueller geht es kaum	positive
Kaum Verz√∂gerungen	positive
Nirgendwo machen Nachrichten mehr Spa√ü als hier!	positive
wirklich lustig ist es nirgendwo	negative
es gibt nirgendwo Informationen zur Fehlerbehebung	negative
der film kommt nie wirklich in fahrt und von horror keine spur.	negative
So kommt nie langeweile auf	positive
ich hab noch nie etwas vergessen	positive
Immer aktuell und interessant noch nie Probleme gehabt	positive
Kann Schr√∂der niemals das Wasser reichen	negative
niemals w√§hlbar f√ºr echte Demokratie	negative
es gibt nirgendwo Korruption	positive
da es nirgendwo in Afghanistan Stabilit√§t gibt	negative
er findet es nicht gut. sie mag es auch nicht.	negative
Der Film ist weder nett, noch besonders.	negative
hat nichts und wieder nichts mit Freiheit zu tun	negative
Der Film geht sehr lange, ist aber nie langweilig	positive
Marlohe hat mir gar nicht gefallen	negative
Wer kann, sollte sich diesen Film nicht entgehen lassen.	positive
Das st√∂rte mich nicht!	positiv
Ich finde nicht, dass es ein schlechter Film ist	positiv
Ich verstehe nicht, wie man so einem sinnlosen und d√§mlichen Film mehr als 1 Stern geben kann.	negative
Auch wenn nicht ganz einwandfrei, ein sehr √ºberzeugender Abschluss.	positiv
Es hat nichts mit Filmverst√§ndniss zu tun, wenn einem der Film in keinster Weise zusagt.	negative
nicht meht und nicht weniger	neutral
So was langweiliges, grottenschlechtes habe ich lange nicht gesehen.	negative
Nichts ist hier zuf√§llig, jedes Szenenbild folgt einem Anspruch von geschichts√ºbergreifender √Ñsthetik. 	positive
Diese Frage sollten sich auch eigentlich Zuschauer stellen, die die B√ºcher nicht gelesen haben.	neutral
Fazit: Ein Kultfilm  Wem's nicht gefallen hat, der hat's nicht verstanden.	positive
Kann zu diesem Film nicht viel sagen, ausser dass er mega spa√ü macht und sehr viel schwarzen Humor mit sich bringt :).	positive
Ich habe wenig bis gar nichts von diesem Film geh√∂rt und grade deswegen bin ich gestern hinein gegangen und wurde mehr als positiv √ºberrascht.	positive
Klar , wenn man sonst nichts zu bieten hat ...	negative